


NO ./assetes/textures/wall_n.png
SO ./assetes/textures/wall_s.png
WE ./assetes/textures/wall_w.png
EA ./assetes/textures/wall_e.png



F       0,                                    0, 0
C 0,200,255



    111111111111111111111111111111111
 1111000000000000000000000000000001
 110000000000000000001000000000000011
 10000000000000000000011111111111111
 11000000000000100100000000000000011111
 1000000000000000000000000000000000011
 100000100100001111000000000000000000011
1110000000000001   100000000000000000001111111111111111111
1000000000000001111000100000000000000000000000001111111111111111
100110000000000011100000000001111111111100101111111111111111111
1111111100000000000000000000000111111110000111111111111111111111
111111000000000000000000000000000000111100E0111111111111111111111
1111110000000000000000000000000000000000000000000011111111111111111111
111111000000000000000000000000000000000001111111111111111111111
11111100000000000000000000000000001111000111111111111111111111
1111110000000000000000000001111111111110000000111111111111111111111
1111110000000000000000000000000000000000000011000011111111111111111111
1111110000000000000000000000000000001100001000000111111111111
1111110000000000000000000000000000000000000000001111111111111111111
111111000000000000000000000011111111111111111111111111111111
    11111111111111111111111111111111111111111111111111111111111111111111



